1111111111111
10C0001C000C1
1001100011001
100P11E01C001
1111111111111