1111111111111
10C0001C000C1
1E01100011001
100P11001C001
1111111111111