1111111111111111111111111111111111
1E00C0010001110C00001000010000C001
1010100100100000101011111101110101
111011C01010101000100000C001010101
1P0000000C001C00001011C011000000C1
1111111111111111111111111111111111