1111111111111111111111111111
1CCCCCCCCCCCC11CCCCCCCCCCCC1
1C1111C11111C11C11111C1111C1
1C1001C10001C11C10001C1001C1
1C1111C11111C11P11111C1111C1
1CCCCCCCCCCCCCCCCCCCCCCCCCC1
1C1111C11C11111111C11C1111C1
1C1111C11C11111111C11C1111C1
1CCCCCC11CCCC11CCCC11CCCCCC1
111111C11111C11C11111C111111
10CC01C11111C11C11111C111111
10C0C1C11CCCCPCCCCC11C0C00C1
1110C1C11C11100111C11C111101
10C0C1C11C10000001C11C10CC01
10C111CCCC10000001CCCC111001
100C01C11C100E0001C11C111111
111100C11C11111111C11C1CC001
100001C11CCCCCCCCCC11000CC01
1111111111111111111111111111