1111111111111111111111111111
1CCCCCCCCCCCC11CCCCCCCCCCCC1
1C1111C11111C11C11111C1111C1
1C1001C10001C11C10001C1001C1
1C1111C11111C11C11111C1111C1
1CCCCCCCCCCCCCCCCCCCCCCCCCC1
1C1111C11C11111111C11C1111C1
1C1111C11C11111111C11C1111C1
1CCCCCC11CCCC11CCCC11CCCCCC1
111111C11111C11C11111C111111
1CCCCCC11111C11C11111CCCCC11
1C1C11C11CCCCPCCCCC11C1C1C11
1C1C11C11C11100111C11C1C1C11
1C1C11C11C10000001C11C1C1C11
1C1C11CCCC100E0001CCCC1C1C11
1C1C11C11C10000001C11C1C1C11
1C1C11C11C11111111C11C1C1C11
1C1C11C11CCCCCCCCCC11C1C1C11
1C1C11C11C11111111C11C1C1C11
111111C11C11111111C11C111111
1CCCCCCCCCCCCC11CCCCCCCCCCC1
1C1111C11111C11C11111C1111C1
1CCC11CCCCCCCCCCCCCCCC11CCC1
1111111111111111111111111111