11111111111111111111111111111111111111111111111
1CCCCCCCCCCCC11CCCCCCCCCCCC11111111111111111111
1C1111C11111C11C11111C1111C11111111111111111111
1C1001C10001C11C10001C1001C11111111111111111111
1C1111C11111C11C11111C1111C11111111111111111111
1CCCCCCCCCCCCCCCCCCCCCCCCCC11111111111111111111
1C1111C11C11111111C11C1111C11111111111111111111
1C1111C11C11111111C11C1111C11111111111111111111
1CCCCCC11CCCC11CCCC11CCCCCC11111111111111111111
111111C11111C11C11111C1111111111111111111111111
1CCCCCC11111C11C11111CCCCC111111111111111111111
1C1C11C11CCCCCCCCCC11C1C1C111111111111111111111
1C1C11C11C11100111C11C1C1C111111111111111111111
1C1C11C11C10000001C11C1C1C111111111111111111111
1C1C11CCCC100EP001CCCC1C1C111111111111111111111
1C1C11C11C10000001C11C1C1C111111111111111111111
1C1C11C11C11111111C11C1C1C111111111111111111111
1C1C11C11CCCCCCCCCC11C1C1C111111111111111111111
1C1C11C11C11111111C11C1C1C111111111111111111111
111111C11C11111111C11C1111111111111111111111111
1CCCCCCCCCCCCC1CCCCCCCCCCCC11111111111111111111
1C1111C11111C11C11111C1111C11111111111111111111
1CCC11CCCCCCCCCCCCCCCC11CCC11111111111111111111
11111111111111111111111111111111111111111111111
